IA=iá
força=fúrça
mosca=môsca
bexiga=bechiga
alexandrina=alechandrina
fast=fésti
food=fúdi
USB/i
ABNT/i
OAB/i
INSS/i
IBGE/i
DNER=deeniéerri
USP=úspi
UNB/i
OMS/i
KDE/i
USD/i
USDT/i
ETH/i
RSI/i
haha=rárrá
hehe=rêrrê
hihi=rírrí
hoho=rorrô
huhu=rurru
cpu=cêpeú
operacoes=operações
operacao=operação
touchpad=tautipédi
touch=tauti
screen=scrim
touchscreen=tautiscrin
daytrade=deitreide
day=dêi
trade=treide
meet=míti
vwap=vêuápi
sera=será
ate=até
certinho=cértínho
keltner=kéltner
altcoins=alticôins
bigtechs=bigtéquis
bigtech=bigtéqui
biglinux=biglínux
cassia=cássia
araujo=araújo
melhroes=melhores
melhr=melhor
patamareas=patamares
ultiamente=ultimamente
precoupar=preocupar
sparkdf=sparkdêéfe
negocios=negócios
solidos=sólidos
solido=sólido
momentaneo=momentâneo
momentaneos=momentâneos
rsync=érressínqui
driver=dráiver
git=guíti
github=guítirrúbi
gitlab=guítiláb
tweaks=tuíques
speed=spídi
speedtest=spíditésti
cast=qésti
podcast=podqésti
catchup=qétchúpi
videogame=vídeoguêime
video=vídio
AC/i
AL/i
AP/i
AM/i
BA/i
CE/i
DF/i
ES/i
GO/i
MA/i
MT/i
MS/i
MG/i
PA/i
PB/i
PR/i
PE/i
PI/i
RJ/i
RN/i
RS/i
RO/i
RR/i
SC/i
SP/i
SE/i
TO/i
maquinas=máquinas
erro=êrro
